1111111111111111
1000110010000001
1000111000011111
1001111110010001
1001001000000001
1001001011101111
1011101001000001
1000000001011101
1111100100010101
1000000101110101
1001111100010001
1001000101111101
1001000000001101
1001111111101101
1000000000001101
1111111111111111